Width 40
Height 40
1 1 1 1 1 1 1 1 1 1 1 1 1 1 1 1 1 1 1 1 1 1 1 1 1 1 1 1 1 1 1 1 1 1 1 1 1 1 1 1 
1 0 0 0 0 0 0 0 0 0 0 0 0 0 0 0 0 0 0 0 0 1 1 1 1 1 0 0 0 0 0 0 0 0 2 0 0 0 0 1 
1 0 0 0 0 7 0 0 0 4 0 0 7 0 0 0 0 0 0 0 0 1 1 1 1 1 0 0 0 0 0 0 0 0 1 0 0 0 0 1 
1 0 0 1 1 1 1 1 1 1 1 1 1 1 0 0 0 0 0 0 0 1 1 1 1 1 0 0 0 0 0 0 0 0 1 0 0 0 4 1 
1 0 0 0 0 0 0 0 0 0 0 0 0 0 0 0 0 0 0 0 0 1 1 1 1 1 0 7 7 0 1 0 0 0 1 7 1 1 1 1 
1 0 7 0 0 0 0 0 0 0 0 0 0 0 0 0 0 0 0 0 0 1 1 1 1 1 1 7 7 0 1 0 1 0 1 0 0 0 0 1 
1 1 1 0 0 0 0 0 0 0 0 0 0 0 0 0 0 0 0 0 0 1 1 1 1 1 0 7 7 0 1 0 0 0 1 0 0 0 0 1 
1 0 0 0 0 1 0 0 0 4 7 0 0 7 0 0 0 7 0 0 0 1 1 1 1 1 0 7 7 0 1 0 0 0 1 1 1 1 7 1 
1 0 0 2 1 1 0 0 1 1 1 1 1 1 1 0 1 1 1 0 0 1 1 1 1 1 0 7 7 0 1 0 0 0 1 1 0 0 0 1 
1 0 0 1 1 0 0 0 0 0 0 0 0 0 0 0 0 0 0 0 0 1 1 1 1 1 1 7 7 0 1 0 1 0 1 1 0 1 1 1 
1 0 1 1 0 0 0 0 0 0 0 0 0 0 0 0 0 0 0 0 0 1 1 1 1 1 0 7 7 0 1 0 0 0 1 1 0 0 0 1 
1 0 0 7 0 0 0 0 0 0 0 0 0 0 0 0 0 0 0 0 0 1 1 1 1 1 0 7 7 0 1 0 0 0 1 1 1 1 7 1 
1 1 1 1 1 1 0 0 0 0 0 0 0 0 0 0 0 0 0 0 0 1 1 1 1 1 0 7 7 0 1 0 0 0 1 0 0 0 0 1 
1 0 0 0 0 1 1 0 0 0 0 0 0 0 0 0 0 0 0 0 0 1 1 1 1 1 1 7 7 0 1 0 1 0 1 0 7 7 0 1
1 0 0 0 7 0 0 0 4 0 0 0 0 0 0 0 0 0 1 7 7 1 1 1 1 1 0 7 7 0 1 0 0 0 1 0 7 7 1 1
1 0 0 0 1 1 1 1 1 1 0 0 1 0 0 0 0 1 1 7 7 1 1 1 1 1 0 7 7 0 1 0 0 0 1 0 7 7 0 1
1 0 0 0 0 0 0 0 0 0 0 0 1 0 0 0 1 1 1 7 1 1 1 1 1 1 0 0 0 0 1 0 0 0 1 0 0 0 0 1
1 0 0 0 0 0 0 0 0 0 0 0 0 0 0 1 1 1 1 7 7 1 1 1 1 1 1 1 0 1 1 0 1 0 1 1 0 1 1 1
1 0 7 4 0 0 3 0 0 7 0 0 0 0 1 1 1 1 1 7 7 1 1 1 1 1 4 0 7 4 1 0 0 0 1 4 7 0 4 1
1 1 1 1 1 1 1 1 1 1 1 1 1 1 1 1 1 1 1 7 7 1 1 1 1 1 1 1 1 1 1 0 0 0 1 1 1 1 1 1
1 1 1 1 1 1 1 1 1 1 1 1 1 1 1 1 1 1 1 1 7 1 1 1 1 1 0 0 0 0 0 0 0 0 0 0 0 0 0 1
1 0 0 0 0 0 0 0 0 0 0 0 0 0 0 0 0 0 0 0 0 1 1 1 1 1 0 1 0 1 0 1 0 1 0 1 0 1 0 1
1 0 0 0 0 7 0 0 0 0 0 0 7 0 0 0 0 0 0 0 0 1 1 1 1 1 7 0 7 0 7 0 7 0 7 0 7 0 7 1
1 0 0 1 1 1 1 1 0 0 1 1 1 1 0 0 0 0 0 0 0 1 1 1 1 1 1 0 1 0 1 0 1 0 1 0 1 0 1 1
1 0 0 0 0 0 0 0 0 1 0 0 0 0 0 0 0 0 0 0 1 1 1 1 1 1 0 0 0 0 0 0 0 0 0 0 0 0 0 1
1 0 7 0 0 0 0 0 0 0 0 0 0 0 0 0 0 0 0 0 0 1 1 1 1 1 0 1 0 1 0 1 0 1 0 1 0 1 0 1
1 1 1 0 0 0 0 0 0 0 0 0 0 0 0 0 0 0 0 0 0 1 1 1 1 1 0 0 0 0 0 0 0 0 0 0 0 0 0 1
1 0 0 0 0 1 0 0 0 4 7 0 0 7 0 0 0 7 0 0 0 1 1 1 1 1 0 0 1 1 1 1 1 1 1 1 1 1 1 1
1 0 0 0 1 1 0 0 1 1 1 1 1 1 1 0 1 1 1 0 0 1 1 1 1 1 0 0 0 0 0 0 0 0 0 0 0 0 0 1
1 0 2 1 1 0 0 0 0 0 0 0 6 0 0 0 0 0 0 0 0 1 1 1 1 1 0 7 0 7 0 7 0 7 0 7 0 0 0 1
1 0 1 1 0 0 0 0 0 0 0 0 6 0 0 0 0 0 0 0 0 0 1 1 1 1 1 1 1 1 1 1 1 1 1 1 1 0 0 1
1 0 0 7 0 0 0 0 0 0 0 0 6 0 0 0 0 0 0 0 0 0 7 7 7 0 0 0 0 0 0 0 0 0 0 0 0 0 0 1
1 1 1 1 1 1 0 0 0 0 0 0 6 0 0 0 0 0 0 0 1 0 7 7 7 0 0 0 0 0 0 0 0 0 0 0 0 0 0 1
1 0 0 0 0 1 1 0 0 0 0 0 6 0 0 0 0 0 0 1 1 1 1 1 1 1 0 0 4 0 0 0 0 0 0 0 0 0 0 1
1 0 0 0 7 0 0 0 4 3 0 0 6 0 0 0 0 3 1 1 1 1 1 1 1 1 1 1 1 1 1 1 1 1 0 0 0 0 1 1 
1 0 0 0 1 1 1 1 1 1 0 0 6 0 0 0 0 1 1 1 1 1 1 1 1 1 1 1 1 1 1 1 1 0 0 0 2 1 1 1 
1 0 0 0 0 0 0 0 0 0 0 0 6 0 0 0 1 1 1 1 1 1 1 1 1 1 7 7 7 1 1 1 0 0 0 0 1 1 1 1
1 0 0 0 0 0 0 0 0 0 0 0 6 0 0 1 1 1 1 1 1 1 1 1 1 1 7 1 1 1 1 0 0 0 0 1 1 1 1 1 
1 0 7 4 0 0 0 0 0 7 0 0 6 0 1 1 1 1 1 1 1 1 1 1 1 1 7 7 7 4 0 0 0 0 1 1 1 1 1 1
1 1 1 1 1 1 1 1 1 1 1 1 1 1 1 1 1 1 1 1 1 1 1 1 1 1 1 1 1 1 1 1 1 1 1 1 1 1 1 1 