Width 20
Height 20
1 1 1 1 1 1 1 1 1 1 1 1 1 1 1 1 1 1 1 1 
1 0 0 0 0 0 0 0 0 0 0 0 0 0 0 0 0 0 0 1 
1 0 0 0 0 4 0 0 0 0 0 3 4 5 0 0 0 0 0 1 
1 0 0 1 1 1 1 1 0 0 1 1 1 1 0 0 0 0 0 1 
1 0 0 0 0 0 0 0 0 1 0 0 0 0 0 0 0 0 0 1 
1 5 4 0 0 0 0 0 0 0 0 0 0 0 0 0 0 0 0 1 
1 1 1 0 0 0 0 0 0 0 0 0 0 0 0 0 0 0 0 1 
1 0 0 0 0 1 0 0 0 5 4 0 0 5 0 0 5 4 0 1 
1 0 0 5 1 1 0 0 1 1 1 1 1 1 1 0 1 1 1 1 
1 0 0 1 1 0 0 0 0 1 0 0 0 0 0 0 0 0 0 1 
1 0 0 0 0 0 0 0 0 1 0 0 0 0 0 0 0 0 0 1 
1 0 0 0 0 4 0 0 0 1 0 0 0 0 0 0 0 0 0 1 
1 1 1 1 1 1 0 0 0 1 0 0 0 0 0 0 0 0 8 1 
1 0 0 0 0 1 0 0 0 1 0 0 0 0 0 0 0 0 1 1 
1 0 0 0 4 0 0 0 5 1 0 0 0 0 0 0 0 0 1 1 
1 0 0 0 1 1 1 1 1 1 0 0 1 0 0 2 0 1 1 1 
1 0 0 0 0 0 0 0 0 0 0 0 1 0 0 0 1 1 1 1 
1 0 0 0 0 0 0 0 0 0 0 0 0 0 1 1 1 1 1 1 
1 0 4 5 0 4 0 0 0 0 0 0 1 1 1 1 1 1 1 1 
1 1 1 1 1 1 1 1 1 1 1 1 1 1 1 1 1 1 1 1 
