Width 20
Height 15
1 1 1 1 1 1 1 1 1 1 1 1 1 1 1 1 1 1 1 1 
1 0 0 0 0 0 0 0 0 0 0 0 0 0 0 0 0 0 0 1 
1 0 0 2 0 7 0 0 0 0 0 0 7 8 0 0 0 0 0 1 
1 0 0 1 1 1 1 1 0 2 1 1 1 1 0 0 0 0 0 1 
1 0 0 0 0 0 0 0 0 1 0 0 0 0 0 0 0 0 0 1 
1 0 7 0 0 0 0 0 0 0 0 0 0 0 0 0 0 0 0 1 
1 1 1 0 0 0 0 0 0 0 0 0 0 0 0 0 0 0 0 1 
1 0 0 0 0 1 0 0 0 3 7 0 0 7 0 0 0 7 0 1 
1 0 0 0 1 1 0 0 1 1 1 1 1 1 1 0 1 1 1 1 
1 0 0 1 1 0 0 0 7 0 0 0 0 0 0 0 0 0 7 1 
1 0 1 1 0 0 0 0 0 0 0 0 0 0 0 0 0 0 0 1 
1 0 0 7 0 0 0 0 0 0 0 0 0 2 0 0 0 0 0 1 
1 1 1 1 1 1 5 0 0 0 0 0 0 1 0 0 0 0 0 1 
1 1 1 1 1 1 1 0 0 0 3 0 3 0 0 3 0 0 0 1 
1 1 1 1 1 1 1 1 1 1 1 1 1 1 1 1 1 1 1 1 
