Width 20
Height 15
1 1 1 1 1 1 1 1 1 1 1 1 1 1 1 1 1 1 1 1 
1 0 0 0 0 0 0 0 0 0 0 0 0 0 0 0 0 0 0 1 
1 0 0 0 0 0 0 0 0 0 0 0 0 0 0 0 0 0 0 1 
1 0 2 0 0 7 0 7 0 0 6 0 0 6 0 0 6 0 0 1 
1 1 1 1 1 1 1 1 1 1 1 1 1 1 1 1 1 1 8 1 
1 0 0 0 0 0 0 0 0 0 0 0 0 0 0 0 0 0 8 1 
1 0 0 0 0 0 0 0 0 0 0 0 0 0 0 0 0 0 8 1 
1 0 4 0 7 0 0 0 7 0 4 0 7 0 0 0 7 0 8 1 
1 8 1 1 1 1 1 1 1 1 1 1 1 1 1 1 1 1 1 1 
1 8 0 0 0 0 0 0 0 0 0 0 0 0 0 0 0 0 0 1 
1 8 0 0 0 0 0 0 0 0 0 0 0 0 0 0 6 3 6 1 
1 8 0 0 0 0 0 7 0 0 0 0 0 0 0 0 1 1 1 1 
1 8 0 0 0 0 0 1 0 0 0 0 0 0 0 0 0 0 0 1 
1 8 0 0 7 0 0 1 0 4 0 4 0 4 0 0 0 0 5 1 
1 1 1 1 1 1 1 1 1 1 1 1 1 1 1 1 1 1 1 1 
